Paragraphs,1859 tokens,1860 tokens,total tokens,EE,HE,EE vs HE
1,193,194,387,579.78,456.13,127.11%
2,232,233,465,726.72,593.15,122.52%
3,679,683,1362,4909.34,5576.78,88.03%
4,772,777,1549,6649.46,7907.39,84.09%
5,810,815,1625,7113.30,7934.86,89.65%
6,942,947,1889,9839.23,10877.44,90.46%
7,1187,1193,2380,16045.75,18487.85,86.79%
8,1363,1369,2732,22128.54,25354.76,87.28%
9,1583,1589,3172,30649.80,36941.59,82.97%
10,1676,1682,3358,34737.72,,#DIV/0!